04 04 04 04 04 04 04 20 20 20 04 04 04 03 04 04 04 04 04 04 04 04 04 03 04 16 17 04 03 04 04 04 04 20 20 20 20 04 04 04 04 04 04 04 04 04 04 04 04 04
04 04 04 04 04 03 04 20 20 04 04 04 04 04 03 03 03 04 04 04 04 04 04 03 04 14 15 04 04 04 03 04 20 20 20 20 04 04 04 04 04 16 17 04 04 04 04 04 04 04
04 04 04 04 04 04 04 20 20 20 04 04 04 03 04 04 04 04 03 04 04 04 04 04 04 04 04 04 04 04 04 20 20 20 20 04 04 04 04 04 04 14 15 04 04 04 03 04 04 04
04 04 04 04 04 04 04 20 20 20 20 04 04 03 03 04 04 04 04 04 03 04 04 04 04 04 04 03 03 20 20 20 20 20 04 04 04 04 04 03 04 04 04 04 16 17 04 04 04 04
04 04 04 03 03 04 03 04 20 20 20 20 04 04 04 04 04 04 04 04 03 04 04 04 03 04 04 04 20 20 20 20 20 04 04 04 04 04 04 03 04 04 04 03 14 15 04 04 04 04
04 04 04 04 16 17 04 04 04 20 20 20 04 04 04 16 17 04 04 04 04 04 04 04 04 04 04 20 20 20 20 20 04 04 04 04 04 04 04 04 04 04 04 04 04 04 04 03 04 04
04 04 04 04 14 15 04 04 04 20 20 20 04 04 04 14 15 08 09 04 04 04 04 16 17 04 04 20 20 20 20 04 03 04 04 04 04 04 16 17 04 04 04 04 04 11 11 11 12 04
04 04 04 04 03 04 04 04 04 20 20 20 04 04 03 04 04 08 09 03 04 04 04 14 15 04 20 20 20 20 04 04 16 17 03 03 04 04 14 15 04 04 04 04 04 06 06 13 09 04
04 04 04 04 04 04 04 20 20 20 20 20 04 04 04 04 04 08 13 11 11 11 11 11 11 12 20 20 20 04 04 03 14 15 03 04 04 04 04 04 04 04 04 04 04 03 04 08 09 04
04 04 04 04 04 04 20 20 20 20 20 04 04 04 04 04 04 05 06 06 06 06 06 06 13 09 20 20 20 04 04 04 04 04 04 04 04 16 17 04 04 04 04 04 04 04 04 08 09 04
04 04 04 04 04 04 20 20 20 04 04 04 04 04 04 04 04 04 03 04 04 04 04 03 08 09 20 20 20 20 04 04 04 04 04 04 04 14 15 03 04 03 04 03 04 16 17 08 09 04
04 04 04 04 04 20 20 20 04 04 04 04 04 04 04 04 04 04 04 04 04 04 04 04 08 09 04 20 20 20 20 04 04 04 04 04 04 04 04 04 04 04 04 04 04 14 15 08 09 04
04 04 04 04 04 20 20 04 04 04 04 18 18 18 18 18 18 18 18 18 18 18 18 04 08 09 04 04 20 20 20 20 04 04 04 04 16 17 04 04 04 04 04 04 04 04 04 08 09 04
04 04 04 04 20 20 20 04 04 04 04 18 02 02 02 02 02 02 02 02 02 02 18 04 08 09 04 04 20 20 20 20 20 04 03 04 14 15 03 04 04 16 17 04 04 04 04 08 09 04
04 04 04 04 20 20 20 04 04 04 04 18 02 02 02 02 02 02 02 02 02 02 18 04 08 09 03 04 04 20 20 20 20 04 04 04 04 04 04 04 04 14 15 04 04 04 04 08 09 04
04 04 04 20 20 20 04 04 04 04 04 18 02 02 02 02 02 02 02 02 02 02 18 04 08 09 04 04 04 04 20 20 20 20 20 04 04 04 03 04 04 04 10 11 11 11 11 13 09 04
04 20 20 20 20 20 04 04 04 04 04 18 02 02 02 02 02 02 02 02 02 02 18 04 08 09 04 04 04 04 04 20 20 20 20 20 04 04 04 04 04 04 08 13 06 06 06 06 07 04
04 20 20 20 04 04 04 04 04 03 04 18 02 02 02 02 02 02 02 02 02 02 18 04 08 09 04 03 03 03 03 04 20 20 20 20 20 04 04 04 04 04 08 09 03 04 04 16 17 04
04 04 04 04 04 04 04 04 04 04 04 19 19 19 19 19 04 04 19 19 19 19 19 03 08 09 03 04 04 04 04 20 20 20 20 20 20 20 04 03 04 04 08 09 04 04 04 14 15 04
04 04 04 04 04 04 04 04 04 04 04 04 00 00 00 04 10 12 04 00 00 00 03 03 08 09 04 04 04 04 20 20 20 20 20 20 20 20 04 04 04 04 08 09 04 04 03 04 04 04
04 04 04 04 03 04 04 04 04 04 04 03 04 04 04 04 08 09 04 03 04 04 04 04 08 09 04 20 20 20 20 20 20 04 04 20 20 20 04 04 04 04 08 09 04 04 04 04 04 04
04 04 03 03 03 04 04 04 04 04 04 04 04 04 04 04 08 09 04 04 04 04 04 04 08 09 20 20 20 20 04 04 04 04 20 20 20 20 04 04 04 04 08 09 04 04 04 04 04 04
04 04 04 10 11 11 11 11 11 11 11 11 11 11 11 11 13 13 11 11 11 11 11 11 13 13 11 11 11 11 11 11 11 11 11 11 11 11 11 11 11 11 13 09 04 04 04 04 04 04
04 04 04 08 13 06 06 06 06 06 06 06 06 06 06 06 06 06 06 06 06 13 13 06 06 06 06 06 06 06 06 06 06 06 06 06 06 06 06 06 13 13 06 07 04 03 04 04 04 04
04 04 04 08 09 04 04 04 04 04 04 04 04 04 04 04 04 04 04 04 04 08 09 04 04 03 20 20 20 04 04 04 04 20 20 20 04 04 04 04 08 09 04 04 04 04 04 04 04 04
04 03 03 08 09 04 04 04 04 04 04 04 04 04 04 04 04 04 04 04 04 08 09 04 04 03 20 20 20 20 04 20 20 20 20 20 04 04 04 04 08 09 16 17 04 16 17 04 04 04
03 04 04 08 09 04 04 04 04 04 16 17 04 04 03 04 04 04 03 04 04 08 09 04 04 03 04 20 20 20 20 20 20 20 20 04 04 04 04 04 08 09 14 15 04 14 15 04 04 04
03 04 04 08 09 04 04 04 04 04 14 15 04 04 04 04 04 04 04 04 03 08 09 04 03 04 04 04 20 20 20 20 20 20 04 04 04 04 16 17 08 09 04 04 04 04 04 04 04 04
04 16 17 08 09 04 04 04 04 04 04 04 04 04 04 04 04 04 04 04 04 08 09 04 04 04 04 20 20 20 20 20 04 04 04 04 04 04 14 15 08 09 04 04 04 03 04 04 03 04
04 14 15 08 09 04 04 04 04 03 04 04 04 16 17 04 04 04 04 04 04 08 09 04 04 04 04 20 20 20 20 04 04 04 04 04 04 04 04 04 08 09 04 04 04 04 16 17 04 04
04 03 03 08 09 04 04 04 16 17 04 04 04 14 15 04 03 03 04 04 04 08 09 04 04 04 04 20 20 20 04 04 04 04 04 04 04 04 04 04 08 09 04 04 04 04 14 15 04 04
04 04 04 08 13 13 04 04 14 15 04 04 04 04 04 04 03 04 04 04 04 08 09 03 04 04 04 20 20 20 04 04 04 04 04 03 04 03 04 04 08 09 04 04 03 04 04 04 04 04
04 04 04 08 13 13 04 04 04 04 04 04 04 04 04 04 04 04 04 04 04 08 09 04 04 04 04 20 20 20 04 04 04 04 04 04 04 16 17 04 08 09 04 04 04 04 04 04 04 04
04 04 04 04 04 04 04 20 20 20 20 20 20 20 04 04 04 04 04 04 04 08 09 04 04 04 04 20 20 20 20 04 04 04 04 04 04 14 15 04 08 09 04 04 04 04 04 04 04 04
04 04 04 04 04 20 20 20 20 20 20 20 20 20 20 04 04 04 04 04 04 08 09 04 04 04 04 20 20 20 20 04 04 04 04 04 04 04 04 04 08 09 04 04 04 04 04 04 04 04
04 04 04 04 20 20 20 20 20 20 20 20 20 20 20 04 04 04 04 04 04 08 09 04 04 04 04 20 20 20 20 04 04 04 04 04 03 04 16 17 08 09 04 04 04 04 04 04 04 04
04 03 04 20 20 20 20 20 20 20 20 20 20 20 20 20 04 03 04 04 04 08 09 04 04 03 04 20 20 20 20 20 04 04 04 03 04 04 14 15 08 09 04 04 04 04 03 04 04 04
04 04 04 20 20 20 20 20 20 20 20 20 20 20 20 20 04 04 04 04 04 08 09 04 04 04 04 04 20 20 20 20 20 04 04 04 04 04 04 04 08 09 03 16 17 04 04 04 04 04
04 04 04 20 20 20 20 20 20 20 20 20 20 20 20 20 04 04 04 04 04 08 09 04 04 03 04 04 04 20 20 20 20 20 04 04 04 04 04 04 08 09 04 14 15 04 03 04 04 04
04 03 04 20 20 20 20 20 20 20 20 20 20 20 20 20 04 04 04 04 04 08 09 04 04 04 04 04 04 04 20 20 20 20 20 04 04 04 04 04 04 04 04 04 04 04 03 04 04 04
04 03 04 04 20 20 20 20 20 20 20 20 20 20 04 04 03 04 04 04 04 08 09 04 04 04 04 03 04 04 04 20 20 20 20 20 04 04 04 16 17 04 04 04 04 04 04 04 03 04
04 04 04 04 04 04 04 04 04 04 04 04 04 04 04 16 17 04 04 04 04 08 09 04 04 04 04 04 04 04 03 04 20 20 20 20 20 04 04 14 15 04 04 04 04 04 04 04 04 04
04 04 04 04 04 04 04 04 03 04 04 04 04 04 04 14 15 04 04 04 04 08 13 11 11 11 04 04 04 04 04 04 04 20 20 20 20 04 04 04 04 04 04 03 03 04 04 03 04 04
04 04 04 03 16 17 03 04 04 03 04 04 03 04 04 04 04 04 04 04 04 08 13 06 06 06 04 03 03 04 04 04 04 20 20 20 20 04 04 04 04 04 04 04 04 04 04 04 04 04
04 04 04 04 14 15 04 04 16 17 04 04 04 04 04 03 03 04 04 04 04 08 09 04 04 04 16 17 04 04 04 04 04 04 20 20 20 04 04 04 04 04 04 04 03 04 04 04 04 04
04 03 03 04 04 04 04 04 14 15 04 04 04 04 11 11 11 11 11 11 11 13 09 04 04 04 14 15 04 04 04 04 04 20 20 20 20 04 04 04 04 03 04 04 04 03 03 04 04 04
04 03 03 04 04 04 04 04 04 16 17 04 04 04 06 06 06 06 06 06 06 13 09 04 04 03 04 04 04 04 04 04 20 20 20 20 04 04 04 04 04 04 03 04 04 04 04 04 04 04
04 04 04 03 16 17 04 04 04 14 15 04 04 03 04 04 04 04 04 04 04 08 09 04 04 04 03 04 04 04 04 20 20 20 20 04 04 04 04 04 04 04 04 04 04 04 04 04 03 04
04 04 04 03 14 15 04 04 04 04 04 04 04 04 04 04 04 04 04 04 04 04 04 04 04 04 04 04 03 04 20 20 20 20 04 04 03 03 04 04 04 04 03 03 04 04 04 04 04 04
04 04 04 04 04 04 04 04 04 04 04 04 04 04 04 04 04 04 04 04 04 04 04 04 04 04 04 04 04 04 04 04 04 04 04 04 04 04 04 04 04 04 04 04 04 04 04 04 04 04